22 65
#.#####......##..............####.......#.....................###
......#.##.........#.#####...#..........#.......................#
.#.......####........#..........#.......#.......................#
.#..###.##..#.########.#####.#..........#.......................#
##..#...#............#...###....#....##########....#####....#.###
##..#...#...####.....#....##....######..#.......................#
##..#...#......#.....#.....#............#...#...................#
##..#...#.###..#.....#.....#..#...$.....#..........#..#.........#
##..#...#......#####.#..................#.......................#
##..#...#............#..#..#..#.........#.....#.........#.......#
................................................................#
............####.###################..########.#.##.##..###.....#
#######.....#......................#..#.#...##..................#
#.....#.....#...################...#..#.........................#
#..#..#.....#.......#..............#..#...####....###############
#..#..#.....#.......#...############..#......#.........#........#
#..#..#######....####...#.............##.#.####........#...##...#
#..#................#...#..............................#..####..#
#..#.............#########...#..#..........#............#...##..#
#..####........................................#.......#........#
#..#...........##########..........#............................#
####....................#########################################